#######################
#*****#***************#
#**##*#*~~~~~~~~~~****#
#**##*#*~~~~~~~~~~****#
#*********************#
#######################
