#######################
#*****#***************#
#**##*#*~~~~~~~~~~****#
#**##*#*~~~~~~~~~~****#
#********************$#
#######################
